Maurice	Kelley
Javier	Lynch
Gordon	Patel
Andrew	King
Bobbie	Barrett
Thelma	Stevens
Roy	Reed
Margarita	Nunez
Lauren	Stone
Albert	Stewart
Kristin	Silva
Matthew	Clark
Rodney	Alexander
Diane	Torres
Kyle	Owens
Justin	Morris
Tony	Simmons
Jamie	Crawford
Alberto	May
Katrina	Contreras
Cecil	Silva
Allen	Griffin
Donna	Martin
Lindsey	Caldwell
Jerry	Adams
Belinda	Chambers
Alvin	Rice
Jared	Harper
Clara	Snyder
Mario	Vasquez
Susan	Garcia
Duane	Richards
Mattie	Weber
Rhonda	Webb
Claude	Guzman
Toni	Guerrero
Herbert	Kennedy
Scott	Allen
Lonnie	Jensen
Stanley	Reynolds
Frederick	Wells
Anita	Olson
Edna	Kim
Brad	Lawrence
Mitchell	Watkins
Gregory	Green
Virgil	Valdez
Salvador	Douglas
Julia	Ross
Sylvia	Bryant
Darrell	Mills
Randall	Tucker
Elsie	Cunningham
Gail	Hicks
Russell	Cruz
Don	Castillo
Marcus	Crawford
Roberta	Dunn
Sherry	Gibson
Shannon	Murray
Edward	Thompson
Lucy	Ray
Allison	Greene
Bonnie	Sanders
Jacob	Stevens
Paula	Jenkins
Guy	Weber
Darryl	Munoz
Eva	Freeman
Glen	Tran
Reginald	Hudson
Dianne	Santos
Velma	Douglas
Sue	Elliott
Roger	Torres
Judith	Cooper
Erik	Morrison
Irma	Burton
Carmen	Alexander
Emma	Mendoza
Ray	Alvarez
Misty	Stanley
Pearl	Larson
Leon	Stone
Julie	Collins
Eddie	Olson
Mark	Thomas
Christine	Campbell
Ann	Evans
Geneva	Lambert
Arlene	Carlson
Leona	Pearson
Henry	Carter
Ramona	Ortega
James	Smith
Christina	Howard
Michael	Brown
Shane	Peters
Elmer	Chapman
Danny	Henderson
Luis	Patterson
Greg	Nichols
Kristina	Keller
Doris	Flores
Juanita	Castillo
Frances	Phillips
Francisco	Simpson
Leslie	Ray
Isabel	Shelton
Irene	Watson
Theresa	Cox
Harold	Mitchell
Ana	Stephens
Corey	Gardner
Barbara	Brown
Alma	Hart
Leo	Rose
Curtis	Ramos
Dwayne	Fuller
Tonya	Lane
Marc	Carroll
Sally	Fox
Douglas	Roberts
Glenn	Hayes
Dora	Howell
Ron	Vargas
Josephine	Ellis
Guadalupe	Powers
Tracy	Guerrero
Kelly	Bell
Marion	Fernandez
Lorraine	Mills
Linda	Williams
Constance	Munoz
Gwendolyn	Fields
Marlene	Salazar
Timothy	Robinson
Chester	Aguilar
Jerome	Warren
Bruce	Bell
Ethel	Marshall
Christopher	Martinez
Gertrude	Johnston
Judy	Kelly
Brandy	Holland
Lester	Castro
Jessie	Richards
Deborah	Clark
Georgia	Morrison
Martin	Myers
Christian	Franklin
Sandra	Moore
Ramon	Hart
Florence	Hamilton
Ben	Perkins
Virginia	King
Everett	Schultz
Steve	Richardson
Lawrence	Peterson
Leslie	Vasquez
Billie	Banks
Ruby	Morales
Bertha	Dixon
Marvin	West
Victoria	Cole
Jacqueline	Long
Ricky	Webb
Joan	Morgan
Annie	Perry
Craig	Morales
Clyde	Arnold
Jeanette	Hawkins
Jill	Robertson
Kristen	Castro
Lindsay	Santiago
Martha	Baker
Kim	Chavez
Rita	Patterson
Manuel	Gonzales
Jeff	Bryant
Dennis	Nelson
Kent	Bates
Amber	Tucker
Tracey	Curtis
Leroy	Snyder
Floyd	Fox
Troy	Washington
Todd	Sanders
Howard	Gray
April	Henry
Ross	Delgado
Gladys	Simmons
Phillip	Foster
Raymond	Scott
Charles	Garcia
Stacy	Daniels
Travis	Gibson
Beatrice	Moreno
Max	Burton
Bessie	Vargas
Casey	Bowman
Carol	Jackson
Bernice	Patel
Daniel	Anderson
Eugene	James
Gary	Lewis
Gloria	Morris
Crystal	Coleman
Dwight	Soto
Agnes	Matthews
Vincent	Cole
Heather	Edwards
Samantha	Ryan
Hattie	Becker
Tracy	Graham
Gerald	Murphy
Jack	Edwards
Betty	Thomas
Bryan	Coleman
Courtney	Williamson
Jesse	Ross
Tyler	Cunningham
Harvey	Carlson
Joy	Guzman
Terrance	Alvarado
Cody	Montgomery
Jennifer	Miller
Andre	Matthews
Jean	Murphy
Paul	Taylor
Marilyn	James
Clinton	Carr
Raul	Carpenter
Tyrone	Mendez
Valerie	Mason
Eileen	Berry
Joyce	Turner
Regina	Rose
Debra	Adams
Marcia	Franklin
Kathy	Ward
Kevin	Gonzalez
Violet	Hopkins
Clifford	Mason
Kirk	Barrett
Benjamin	Bailey
Rachel	Gray
Katherine	Rogers
Erika	Estrada
Ken	Walsh
Karl	Greene
Nelson	Hanson
Jonathan	Flores
Patrick	Ramirez
Ronald	Lopez
Eric	Sanchez
Maria	Davis
Robin	Fisher
Tanya	Lynch
Marie	Mitchell
Ian	Reid
Juan	Collins
Tamara	Burke
Joe	Parker
Leah	May
Julian	Holland
Geraldine	Holmes
Francis	Mcdonald
Suzanne	Hunter
Sonia	Pena
Marjorie	Harrison
Carl	Phillips
Tommy	Holmes
Joanne	Jimenez
Vicki	Carroll
Megan	Gordon
Isaac	Wong
Cynthia	Walker
Rosemary	Armstrong
Claudia	Obrien
John	Johnson
Marsha	Soto
Randy	Bennett
Carolyn	Ramirez
Louis	Wood
Derrick	Fernandez
Marion	Keller
Dawn	Jordan
Ricardo	Hawkins
Harriet	Maldonado
Alice	Parker
Gabriel	Garza
Charlie	Elliott
Norman	Wallace
Roland	Wheeler
Leonard	Hamilton
Janet	Roberts
Veronica	Palmer
Dale	Kim
Sheila	Ford
Warren	Boyd
Sean	Ortiz
Natalie	Willis
Dolores	Schmidt
Tina	Sullivan
Nicholas	Cooper
Milton	Riley
Shelly	Alvarado
Minnie	Carr
Sara	Price
Julio	Harvey
Oscar	Gordon
Yolanda	Peters
Tara	Duncan
Richard	Davis
Adam	Kelly
Ruth	Thompson
Tim	Moreno
Joseph	Rodriguez
June	Medina
Kathryn	Cruz
Wallace	Fields
Hugh	Sims
Cecilia	Vega
Johnny	Perry
Andy	Pena
Natasha	Byrd
Edgar	Lane
Edwin	Mendoza
Sarah	Gonzalez
Jeffrey	Hall
Stacey	Carpenter
Wanda	Foster
Felix	Welch
Faye	Lowe
Peggy	Henderson
Rafael	Johnston
Frank	Young
Catherine	Carter
Jimmy	Barnes
Nathan	Graham
Lydia	Gilbert
Armando	Mccoy
Laura	Lee
Stephanie	Hill
Tammy	Wood
Katie	Hansen
Hazel	Washington
Alexander	Burns
Pamela	Green
Philip	Jenkins
Seth	Stanley
Beth	Knight
Ella	Riley
Barry	Freeman
Danielle	Shaw
Becky	Sandoval
Denise	Richardson
Brenda	Young
Ada	Rhodes
Evelyn	Nguyen
Jay	Wagner
Joel	Woods
Connie	Reynolds
Nellie	Bishop
Jo	Dean
Phyllis	Russell
Larry	Perez
Robert	Williams
Lillie	Jacobs
Willard	Curtis
Marshall	Rios
Elaine	Mcdonald
Hilda	Reid
Dana	Weaver
Ruben	Duncan
Micheal	Jimenez
Kelly	Oliver
Perry	Sandoval
Joann	Boyd
Nathaniel	Andrews
Jeanne	Bradley
Colleen	George
Bradley	Harrison
Maureen	Harper
Billy	Diaz
Vanessa	Hoffman
Eduardo	Ortega
Nicole	Gomez
Charlotte	Kennedy
Chad	Ellis
Charlene	Garza
Vera	Chapman
Christy	Chen
Sheryl	Craig
Willie	Lawrence
Terry	Garrett
Clayton	Garrett
Heidi	Austin
Ronnie	Palmer
Anna	Sanchez
David	Miller
Darren	Gilbert
Ralph	Morgan
Diana	Gutierrez
Sam	Grant
Renee	Gardner
Harry	Howard
Victor	Price
Jose	Walker
Daryl	Pearson
Glenda	Mendez
Daisy	Beck
Viola	Jensen
Pauline	Woods
Darlene	Hunt
Samuel	Cook
Ryan	Turner
Theodore	Porter
Vickie	Hanson
Janice	Bailey
Audrey	Ferguson
Jessie	Lawson
Angela	Perez
Rene	Beck
Eleanor	Porter
Marguerite	Frazier
Ellen	Owens
Sidney	Brewer
Margie	Fowler
Jaime	Fowler
Steven	Jackson
Dan	Weaver
Amanda	Nelson
Olga	Wong
Sabrina	Gregory
Vivian	Kelley
Arthur	Evans
Alan	Powell
Delores	Watkins
Brett	Armstrong
Brittany	Arnold
Tiffany	Gonzales
Johnnie	Newman
Edith	Hayes
Wayne	Cox
Cathy	Meyer
Helen	Hernandez
Karen	Taylor
Wendy	West
Yvonne	Nichols
Penny	Day
Andrea	Reyes
Erica	Rice
Dustin	Medina
Lori	Bennett
Cora	Leonard
Melanie	Tran
Miguel	Shaw
Peter	Campbell
Fernando	Bishop
Kimberly	Harris
Adrian	George
Cory	Burke
Miriam	Rios
Carrie	Ruiz
Rebecca	Wright
Kathleen	Scott
Tom	Romero
Antonio	Fisher
Kurt	Howell
Cheryl	Rivera
Clifton	Santos
Ashley	Peterson
George	Moore
Amy	Allen
Ivan	Schneider
Fred	Ward
Priscilla	Newman
Jesus	Ruiz
Lynn	Warren
Willie	Rogers
Jason	Harris
Myrtle	Mccoy
Jackie	Lawson
Nina	Bowman
Loretta	Spencer
Pedro	Ryan
Esther	Alvarez
Lucille	Simpson
Ted	Salazar
Michelle	Lopez
Marian	Montgomery
Herman	Payne
Morris	Banks
Rosa	Ramos
Ida	Payne
Mabel	Fuller
Teresa	Stewart
Jessica	Lewis
Jeffery	Chavez
Dorothy	Wilson
Deanna	Schultz
Caroline	Oliver
Jordan	Walters
Thomas	Wilson
Alex	Dixon
Keith	Rivera
Angel	Berry
Melinda	Wheeler
Wesley	Schmidt
Bob	Little
Debbie	Burns
Kay	Schneider
Lance	Williamson
Roberto	Pierce
Jane	Brooks
Emily	Barnes
Gilbert	Knight
Allan	Dean
Cassandra	Davidson
Michele	Romero
Dave	Day
Brandon	Gomez
William	Jones
Mike	Jordan
Lee	Murray
Neil	Obrien
Zachary	Stephens
Gene	Bradley
Mildred	Cook
Shirley	Robinson
Sherri	Wade
Beverly	Diaz
Earl	Butler
Dean	Ferguson
Claire	Barnett
Laurie	Grant
Chris	Gutierrez
Vernon	Dunn
Brian	White
Lena	Welch
Stella	Harvey
Carla	Hudson
Cindy	Wallace
Patricia	Johnson
Calvin	Hicks
Jon	Hunt
Alfred	Marshall
Holly	Pierce
Margaret	Rodriguez
Rose	Reed
Wilma	Perkins
Mathew	Austin
Louise	Hughes
Byron	Lucas
Jennie	Walsh
Felicia	Valdez
Lillian	Butler
Nora	Little
Lloyd	Black
Carlos	Reyes
Mary	Smith
Bobby	Hughes
Naomi	Brewer
Stephen	Wright
Anne	Myers
Annette	Herrera
Sergio	Hopkins
Carole	Lucas
Jim	Hunter
Kenneth	Martin
Mae	Bates
Monica	Wells
Ernest	Long
Jorge	Herrera
Erin	Black
Gina	Aguilar
Nancy	Anderson
Rick	Hansen
Terri	Andrews
Maxine	Sims
Clarence	Russell
Sharon	White
Melvin	Ford
Joshua	Baker
Bill	Robertson
Franklin	Willis
Jeremy	Watson
Derek	Meyer
Shawn	Sullivan
Jimmie	Chen
Alicia	Wagner
Terry	Nguyen
Molly	Fleming
Walter	Hill
Aaron	Brooks
Lois	Powell
Jamie	Jacobs
Alfredo	Davidson
Hector	Spencer
Arnold	Larson
Grace	Griffin
Donald	Hernandez
Brent	Hoffman
Melissa	Hall
Patsy	Walters
Jenny	Delgado
Lisa	Martinez
Lewis	Daniels
Bernard	Henry
Norma	Ortiz
Elizabeth	Jones
Anthony	Lee
